WWWWWWWWWWWWWWWWWWWWWWWWWWWWWWWWWWWWWWWWWWWWWWWWWWWWWWWWWWWW
WWWWWWWWWWWWWWWWWWWWWWWWWWWWWWWWWWWWWWWWWWWWWWWWWWWWWWWWWWWW
WWWE WWWWWW     WWWWWW     WWWWWW   WWWWWW  BB   WWWWWWBEWWW
WWW    WW        KWW         WW         WW        KWW D  WWW
WWWWW      WWBWW      WW WW      WW WW      WW WW     DWWWWW
WWW  WW  WW DDD WW  WW     WW  W    WW  WW     W    KWW  WWW 
WWW  WW  WW     WW  WW     WW  WW     WW  WW     WW  WW  WWW
WWW  WW  WWB     WW  WW     WW  WW     WW  WW     WW WW KWWW
WW     WW  DDW     WW     W     WW    W     WW    W     WWWW
WWWWWWWWWWWWWWWWWWWWD        DD       WWWWWWWWWWWWWWWWWWWWWW
WWWWWWWWWWWWWWWWWWWW                  WWWWWWWWWWWWWWWWWWWWWW
WWWWWWWWWWWWWWWWWWWWJ                 WWWWWWWWWWWWWWWWWWWWWW
WWWWWWWWWWWWWWWWWWWWWWWWWWWW WWWWWWWWWWWWWWWWWWWWWWWWWWWWWWW
WWWWWWWWWWWWWWWWWWWWWWWWWWWW WWWWWWWWWWWWWWWWWWWWWWWWWWWWWWW
WWWWWWWWWWWWWWWWWWWWWWWWWWWW WWWWWWWWWWWWWWWWWWWWWWWWWWWWWWW
WWWWWW             WWWWWWWWW WWWWWWWWWWWWWWWWWWWWWWWWWWWWWWW
WWWWWWWWWWWWWWWWWWWWWWWWWWWW WWWWWWWWWWWWWWWWWWWWWWWWWWWWWWW
WWWWWWWWWWWWWWWWWWWWWWWWWWWW WWWWWWWWWWWWWWWWWWWWWWWWWWWWWWW
WWWWWWWWWWWWWWWWWWWWWWWWWWWW WWWWWWWWWWWWWWWWWWWWWWWWWWWWWWW
WWWWWWWWWWWWWWWWWWWWWWWWWWWW WWWWWWWWWWWWWWWWWWWWWWWWWWWWWWW
WWWWWWWWWWWWWWWWWWWWWWWWWWWW WWWWWWWWWWWWWWWWWWWWWWWWWWWWWWW
WWWWWWWWWWWWWWWWWWWWWWWWWWWW WWWWWWWWWWWWWWWWWWWWWWWWWWWWWWW
WWWWWWWWWWWWWWWWWWWWWWWWWWWW WWWWWWWWWWWWWWWWWWWWWWWWWWWWWWW
WWW                                                      WWW
WWWWWWWWWWWWWWWWWWWWWWWWWWWWWWWWWWWWWWWWWWWWWWWWWWWWWWWWWWWW